edolnx	Carl Perry	foo
jayskwak	Jae Yang Kwak, Korea	foo
naz	TBA	foo
blauwers	Bart Lauwers, Belgium	foo
wmertens	Wout Mertens, Belgium	foo
prez	Preston A. Elder, USA	foo
ashmodai	Mike Jones, Canada	foo
tutor	Peter W. Michaleas, USA	foo
bass	José Alberto Suárez López, Spain	foo
sandymac	William A. McArthur Jr.	foo
daybird	David Chamberlain	foo
murphy	Maarten Thibaut, Belgium	foo
rphillips	Ryan Phillips	foo
bangert	Thilo Bangert	foo
kain	Bryon Roche	foo
pvdabeel	Pieter Van den Abeele	foo
meekrob	Sherman Boyd	foo
mkennedy	Matthew Kennedy	foo
george	George Shapovalov	foo
jhhudso	Jared H. Hudson	foo
spider	D.M.D. Ljungmark	foo
seemant	Seemant Kulleen	foo
mjc	Michael J. Cohen	foo
agenkin	Arcady Genkin	foo
m0rpheus	Ferry Meyndert	foo
tod	Tod Neidt	foo
achim	Achim Gottinger	foo
guidob	Guido Bakker	foo
jnelson	Jon Nelson	foo
verwilst	Bart Verwilst	foo
azarah	Martin Schlemmer	foo
chouser	Chris Houser	foo
chadh	Chad Huneycutt	foo
woodchip	Don Davies	foo
agriffis	Aron Griffis	foo
kabau	Damon M. Conway	foo
karltk	Karl Trygve Kalleberg	foo
blocke	Bruce A. Locke	foo
danarmak	Dan Armak	foo
drobbins	Daniel Robbins	foo
g2boojum	Grant Goodyear	foo
